从概念上看,奶油收入有两个基本方面产品和地理.	从概念上看,奶油收入有两个基本方面产品和地理.
你知道在这个季节,我猜在你的水平你把他们丢到下一个水平	你知道在这个季节,我猜在你的水平你把他们丢到下一个水平
我们的一个号码会非常详细地执行你的指示	我们的一个号码会非常详细地执行你的指示
你怎么知道的?所有这些都是他们的信息.	你怎么知道的?所有这些都是他们的信息.
网球鞋有一系列的价格.	网球鞋有一系列的价格.
我的随身听坏了所以我现在不高兴了我只能把立体声调大声	我的随身听坏了所以我现在不高兴了我只能把立体声调大声
但有几个基督教镶嵌在apse之上,是处女与婴儿耶稣	但有几个基督教镶嵌在apse之上,是处女与婴儿耶稣
男女同性恋.	男女同性恋.
在ruedes法郎的结束时	在ruedes法郎的结束时
我穿过一套舱门然后掉到地上	我穿过一套舱门然后掉到地上
对成人和儿童来说很有趣.	对成人和儿童来说很有趣.
不是他们问的问题是不有趣或合法的(虽然大多数都属于已经要求和回答的类别).	不是他们问的问题是不有趣或合法的(虽然大多数都属于已经要求和回答的类别).
底比斯一直掌权直到第12王朝第一个国王amenemhetiwho在公元前1980年在孟菲斯附近建立了一个首都	底比斯一直掌权直到第12王朝第一个国王amenemhetiwho在公元前1980年在孟菲斯附近建立了一个首都
我并不想对你的关切感到油腔滑调	我并不想对你的关切感到油腔滑调
数据综述中的问题.	数据综述中的问题.
你在电视上也看到了	你在电视上也看到了
Vrenna和我都打了他,他差点把我们带走.	Vrenna和我都打了他,他差点把我们带走.
这项分析汇集了这两项研究的估计数,以开发一个与慢性支气管炎有关的c-r功能.	这项分析汇集了这两项研究的估计数,以开发一个与慢性支气管炎有关的c-r功能.
他转身微笑在vrenna.	他转身微笑在vrenna.
我们力求确定各机构在过去5年中共同执行的做法.	我们力求确定各机构在过去5年中共同执行的做法.
其他人都不稳定	其他人都不稳定
它没有必要做任何改进.	它没有必要做任何改进.
嗯,这是非常有趣的	嗯,这是非常有趣的
他开始慢慢回到工棚.	他开始慢慢回到工棚.
这是相当有一点我认为六个东西是州	这是相当有一点我认为六个东西是州
每个人都知道从mallorcan祖先传来的食谱.	每个人都知道从mallorcan祖先传来的食谱.
是啊,你是一个学生	是啊,你是一个学生
我真的听到了一些东西他们应该在纽约发起一场大规模的运动关于虐待儿童和制止虐待儿童	我真的听到了一些东西他们应该在纽约发起一场大规模的运动关于虐待儿童和制止虐待儿童
邮政服务是为了减少交货频率.	邮政服务是为了减少交货频率.
经济的另一个转变被认为更有营养.	经济的另一个转变被认为更有营养.
该规则有数据收集要求,有助于环保局实现其排放控制目标.	该规则有数据收集要求,有助于环保局实现其排放控制目标.
几乎每一座山都有一个摩尔人堡垒;	几乎每一座山都有一个摩尔人堡垒;
费利西亚的旅程是在它的中央一个年轻的爱尔兰女孩菲利西亚的眼中发生的	费利西亚的旅程是在它的中央一个年轻的爱尔兰女孩菲利西亚的眼中发生的
在地窖里埋葬了伏尔泰和卢梭	在地窖里埋葬了伏尔泰和卢梭
我记不起他们的名字了	我记不起他们的名字了
我很抱歉他会接管我认为我自己的调查.	我很抱歉他会接管我认为我自己的调查.
